bin	A
bist	A
bleibe	V
bleibest	V
bleibet	V
bleibst	V
bleibt	V
blieb	V
bliebe	V
blieben	V
bliebest	V
bliebet	V
bliebst	V
bliebt	V
darf	M
darfst	M
durfte	M
durften	M
durftest	M
durftet	M
dürfe	M
dürfen	M
dürfest	M
dürfet	M
dürft	M
dürfte	M
dürften	M
dürftest	M
dürftet	M
gab	V
gaben	V
gabst	V
gabt	V
galt	V
galten	V
galtest	V
galtet	V
galtst	V
gebe	V
gebest	V
gebet	V
gebt	V
geh	V
gehe	V
gehest	V
gehet	V
gehst	V
geht	V
gelte	V
geltest	V
geltet	V
gib	V
gibst	V
gibt	V
gilst	V
gilt	V
ging	V
ginge	V
gingen	V
gingest	V
ginget	V
gingst	V
gingt	V
gäbe	V
gäben	V
gäbest	V
gäbet	V
gäbst	V
gälte	V
gälten	V
gältet	V
gölte	V
gölten	V
göltet	V
hab	A
habe	A
habest	A
habet	A
habt	A
hast	A
hat	A
hatte	A
hatten	A
hattest	A
hattet	A
heiß	V
heiße	V
heißest	V
heißet	V
heißt	V
hieß	V
hieße	V
hießest	V
hießet	V
hießt	V
hätte	A
hätten	A
hättest	A
hättet	A
ist	A
kam	V
kamen	V
kamst	V
kamt	V
kann	M
kannst	M
komme	V
kommest	V
kommet	V
kommst	V
kommt	V
konnte	M
konnten	M
konntest	M
konntet	M
käme	V
kämen	V
kämest	V
kämet	V
kämst	V
kämt	V
könne	M
könnest	M
könnet	M
könnt	M
könnte	M
könnten	M
könntest	M
könntet	M
lag	V
lagen	V
lagst	V
lagt	V
lass	V
lasse	V
lassest	V
lasset	V
lasst	V
laß	V
laßt	V
lieg	V
liege	V
liegest	V
lieget	V
liegst	V
liegt	V
ließ	V
ließe	V
ließen	V
ließest	V
ließet	V
ließt	V
läge	V
lägen	V
lägest	V
läget	V
lägst	V
lägt	V
lässt	V
läßt	V
mach	V
mache	V
machest	V
machet	V
machst	V
macht	V
machte	V
machten	V
machtest	V
machtet	V
mag	M
magst	M
mochte	M
mochten	M
mochtest	M
mochtet	M
muss	M
musst	M
musste	M
mussten	M
musstest	M
musstet	M
muß	M
mußt	M
mußte	M
mußten	M
mußtest	M
mußtet	M
möchte	M
möchten	M
möchtest	M
möchtet	M
möge	M
mögen	M
mögest	M
möget	M
müsse	M
müssest	M
müsset	M
müsst	M
müsste	M
müssten	M
müsstest	M
müsstet	M
müßt	M
müßte	M
müßten	M
müßtest	M
müßtet	M
sag	V
sage	V
sagest	V
saget	V
sagst	V
sagt	V
sagte	V
sagten	V
sagtest	V
sagtet	V
sah	V
sahst	V
saht	V
sashen	V
sehe	V
sehest	V
sehet	V
seht	V
sei	A
seid	A
seien	A
seiest	A
seist	A
sieh	V
siehe	V
siehst	V
sieht	V
sind	A
soll	M
solle	M
sollest	M
sollet	M
sollst	M
sollt	M
sollte	M
sollten	M
solltest	M
solltet	M
stand	V
standen	V
standest	V
standet	V
standst	V
steh	V
stehe	V
stehest	V
stehet	V
stehst	V
steht	V
stände	V
ständen	V
ständest	V
ständet	V
stünde	V
stünden	V
stündest	V
stündet	V
sähe	V
sähen	V
sähest	V
sähst	V
säht	V
vergeh	V
vergehe	V
vergehest	V
vergehet	V
vergehst	V
vergeht	V
verging	V
vergingen	V
vergingest	V
verginget	V
vergingst	V
vergingt	V
war	A
waren	A
warst	A
wart	A
werde	V
werdest	V
werdet	V
will	M
willst	M
wird	V
wirst	V
wolle	M
wollest	M
wollet	M
wollt	M
wollte	M
wolltest	M
wolltet	M
wurde	V
wurdest	V
wurdet	V
wäre	A
wären	A
wärest	A
wäret	A
wärst	A
wärt	A
würde	V
würdest	V
würdet	V